# # # # # # # # # # # . . . . . . # # # # # # # #
# M . . . . . . . . # . . . . . . # . # . # . . #
# . # # . # # # # . # . . . . . . # . # . # # . #
# . # # . . . . # . # # # # # # # # . . . . . . #
# . . . . . . . # . . . . . . . . . . # . . P . #
# . # # # . . . # # # # # # # # # # # # . # # . #
# . # . # # . # # # # . . . . . . # . # . # . . #
# . # . . . . . . . # . . . . . . # . . F . . . #
# # # . . # # # # # # . . . . . . # # # # # # # #
# . # . . # . . . . . . . . . . . . . . . . . . #
# . . . . . . . . . . . . . # . . . . . . . . . #
# . . . . . . . . . . . . . # . . . . . . . . . #
# . . . . . . . . . . . . . # . . . . . . . . S #
# # # # # # # # # # # # # # # # # # # # # # # # #