# # # # # # # # # # # . . . . . . # # # # # # # #
# . . . . . . . . . # . . . . . . # . # . # . . #
# . # # . # # # # . # . . . . . . # . # . # # . #
# . # # . . . . # . # # # # # # # # . . . . . . #
# . . . . . . . # . . . . . . . . . . # . . P . #
# . # # # . . . # # # # # # # # # # # # . # # . #
# . # . # # . # # # # . . . . . . # . # . # . . #
# . # . . . . . . . # . . . . . . # . . F . . . #
# # # . . # # # # # # . . . . . . # # # # # # # #
# . # . . # . . . . . . . . . . . . . . . . . . #
# . . . . . . . . . . . . . # . . . . . . . . . #
# . . . . . . . . . . M . . # . . . . . . . . . #
# . . . . . . . . . . . . . # . . . . . . . . S #
# # # # # # # # # # # # # # # # # # # # # # # # #